NO ./textures/watM_64.xpm
SO ./textures/cry_64.xpm
WE ./textures/watG_64.xpm
EA ./textures/agreed_64.xpm

C 110,80,40
F 100,130,255

        1111111111111111111111111
        1000000000110000000000001
        1011000001110000000000001
        1001000000000000000000001
111111111011000001110000000000001
100000000011000001110111111111111
11110111111111011100000010001
11110111111111011101010010001 111111
11000000110101011100000010001 100001
10000000000000001100000000001 111111
10000000000000001101010000001
11000001110101011111011110001
1111N111 1110101 101111010001
11111111 1111111 111111111111