1111111
100101
101001
1100N1       111111
111111       100001
             111111