


111111
1001001
 101001
110N11       111111
1111111       100001
             111111


