1111111
1001001
1000001
1100001    111111
1111111    100001
           111111