


111111
1001001
 101101
1101N1       111111
1111111       100001
             111111


