1111111
10001S1
1000001
1100001    111111
1111111    100001
           111111