1111111
1001001
100N001
1100001    111111
1111111    100001
           111111