NO ./textures/bluestone.xpm
SO ./textures/mossy.xpm
WE ./textures/wood.xpm
EA ./textures/colorstone.xpm

F 110,80,40
C 100,130,255

1111111
10001S1
1000001       111
11000011111111101
11111000000000001
    1111111111111